minSeqLength	350
maxSeqLength	100000000
minAvgQuality	16
maxAccumulatedError	-1
maxAmbiguousNT	-1
maxHomonucleotide	40
QualWindowWidth	300
QualWindowThreshhold	5
TrimWindowWidth	15
TrimWindowThreshhold	-1
maxBarcodeErrs	0
maxPrimerErrs	3
keepBarcodeSeq	0
keepPrimerSeq	0
fastqVersion	auto
TechnicalAdapter	
TrimStartNTs	0
PEheaderPairFmt	1
BinErrorModelMaxExpError	0
BinErrorModelAlpha	-1

illuminaFwd	TTTCTGTTGGTGCTGATATTGC
illuminaRev	ACTTGCCTGTCGCTCTATCTTC
illuminaSngIdx	
illuminaSngUni	
RejectSeqWithoutRevPrim	F
RejectSeqWithoutFwdPrim	F
AmpliconShortPE	F
