minSeqLength	170
maxSeqLength	400
minAvgQuality	25
maxAccumulatedError	2
maxAmbiguousNT	2
maxHomonucleotide	18
QualWindowWidth	30
QualWindowThreshhold	0
TrimWindowWidth	15
TrimWindowThreshhold	21
maxBarcodeErrs	0
maxPrimerErrs	3
keepBarcodeSeq	1
keepPrimerSeq	0
fastqVersion	auto
TechnicalAdapter
TrimStartNTs	0
PEheaderPairFmt	1
BinErrorModelMaxExpError	4
BinErrorModelAlpha	0.01


illuminaFwd	TACACTCTTTCCCTACACGACGCTCTTCCGATCT
illuminaRev	GTGACTGGAGTTCAGACGTGTGCTCTTCCGATCT
illuminaSngIdx	AGATCGGAAGAGCACACGTCTGAACTCCAGTCAC
illuminaSngUni	AGATCGGAAGAGCGTCGTGTAGGGAAAGAGTGTA
RejectSeqWithoutRevPrim	F
RejectSeqWithoutFwdPrim	F
AmpliconShortPE	F
